1111111111
1C11CC11E1
1110000001
100C000001
1111000011
1P00000011
1111111111
