111111111111111111111
1P0000000C0000000E0C1
111111111111111111111
