1111111111111
10P000C011111
1111011111111
1000000111101
10000C000E011
1111111111111
