111111111111111111111
10000C100P001000000C1
101011101110111011111
101000001000000010001
101111111011111110101
1000100C101C001000101
111010111011101011101
100010001000101000101
101111101010101110101
10100C1000100010001C1
101011111111111011111
101010000000100000001
101010111011101111101
101000100010001C00101
101011101110111110101
101000101000100000101
101010101011101111101
1C0010100000000010001
111110111111111110101
100000000C1E0000001C1
111111111111111111111

