111111111111111111111
10000C100P001000000C1
101011101110111011111
101000001000000010001
101111111011111110101
1000100C101E001000101
111010111011101011101
100000001000101000101
101111101010101110101
10000C1000100000001C1
111111111111111111111

