1111111111
1000000001
1000000011
1111000001
1111101111
