100010101001010
101110101010101
1010101010101101101
101010101010
101100101
101010
1010101010010111
1000110111000110
10010010010110101
110110100110100101