1111111111
10010CCE11
1111001111
1CCC011111
1P00001111
1111111111
