1111111111
10000000E1
1000000001
100C000001
100C0C0001
1000000001
1000000001
1000P00001
1000000001
1111111111
